#.................................................
..................................................
..................................................
..#...............................................
...#..............................................
..................................................
....#.............................................
.....#............................................
......#...........................................
......#...........................................
.......#..........................................
........#.........................................
........##........................................
.........#........................................
..........#.......................................
..........##......................................
...........##.....................................
............#.....................................
............##....................................
.............##...................................
..............##..................................
..............##..................................
...............##.................................
................##................................
................###...............................
.................##...............................
..................##..............................
..................###.............................
...................###............................
....................###...........................
....................###...........................
.....................###..........................
......................###.........................
......................####........................
.......................###........................
........................###.......................
........................####......................
.........................####.....................
..........................###.....................
..........................####....................
...........................####...................
...........................#####..................
............................####..................
.............................####.................
.............................#####................
..............................#####...............
...............................####...............
...............................#####..............
................................#####.............
.................................#####............